p	p
b	b
f	f
m	m
t	t
d	d
l	l
n	n
s	s
z	z
r	r
sy	ʃ
th	ʈ
dh	ɖ
c	t͡ʃ
j	d͡ʒ
y	j
ny	ɲ
k	k
g	g
kh	x
w	w
ng	ŋ
'	ʔ
h	h
i	i
e	e
ex	ə
a	a
u	u
o	o
ox	ɔ
